0000000000000000
0111101001101000
0111101001111000
0111101101011100
0111101111011110
0111100000000110
0111111111101110
0111101111101000
0111101111101110
0111101111101100
0111101111111110
0111100000011110
0101111101011100
0110111011011110
0111101111011110
0000000000000000

0000000000000000
0111101111011110
0110111011011110
0101111101011100
0111100000011110
0111101111111110
0111101111101100
0111101111101110
0111101111101000
0111111111101110
0111100000000110
0111101111011110
0111101101011100
0111101001011000
0111101001111000
0000000000000000