$8&9
00000000
01111010
01111010
01111010
01111010
01111000
01111110
00000000
00000000